20 30
##############################################################################        ########
#                #
#       #
#
#  2
##      #                   ################### ########################
# #       # #                                        #####
#  @             #          ################################################
#    ##    # #             @ @@
#########################@@ ##############################
#
#
##                           ####
##
#
#
#                            1
#
#
 ###################################################################################################

