2 - A duel in the mine field
MaxSteps=2000
NumShells=10
Rows= 27
Cols=29
# ###########################
#           1               #
#               @@          #
#    @                      #
#        @ @@ @ @      @@   #
#    @ @@ @ @               #
#                 @ @@ @ @  #
#     @@                    #
      @ @       #   #     @ @
#                           #
#      @ @ @ @ @ @          #
#          #   #      ##   ##
@    @            @         @
#           @               #
## @@            #    #     #
#     @@@@@                 #
#       @        @@@@@      #
#    @@@      @@@@          #
#        @    @ @@ @ @      #
#  @                        #
#     @ @@ @ @        @     #
#          #    #      #   ##
@     @@@@@@@@@             @
#           @               #
##   @           #    #     #
#           2               #
# ################## ########
